Area,Stage,Level,LevelMin,Exp,ExpMin
1,1,1,5,3,1
1,2,5,10,5,2
2,1,1,1,1,1
2,2,1,1,1,1
3,1,1,1,1,1
3,2,1,1,1,1
4,1,1,1,1,1
4,2,1,1,1,1